5 13 31
###############################
#p * *3       *  ** * *      *#
# # # # #*# # #*# # # # # #*# #
#    * * *** **  5   *    **  #
# #*# # # # #4# #b#1# # # # #*#
#          *     **      *  **#
# # #*# # # # # #*#*#*#d# # # #
#   *        *   * *x* *   4  #
# # # # #*# # # # # # #*# #*# #
#   *v**         *2           #
# # # # # # # # # #*# # # # #*#
#  ** *5  *    2              #
###############################