9 13 31
###############################
#p * *        *  *  * *      *#
# # # # #*# # #*# # # # # #*# #
#    * * *** **  6   *    **  #
# #*#*# # # # # #s# # # # # #*#
#          *     **      *   *#
# # #*# # # # # #*#*#*#*# # # #
#   *        *   * *x* *   4  #
# # # # #*# # # # # # #*# #*# #
#   * **         *4       8   #
# # # # # # # # # #*# # # # #*#
#  ** *4  *    6        b     #
###############################