99 13 31
###############################
#p * *        *  *  * *     1*#
# # # # #*# # #*# # # # # #*# #
#w   n * *** **      *    **2 #
# #*#*# # # # # #s# # # # # #*#
#f   s     *     **      *  3*#
# # #*# # # # # #*#*#*#*# # # #
#v  b        *   * *x* *   4  #
#i# # # #*# # # # # # #*# #*# #
#   * **         *        8   #
#d# # # # # # # # #*# # # # #*#
#  ** *5  *    6        7     #
###############################

// Level này dùng để test, review all item - mob, quay vid bài nộp!