6 13 31
###############################
#p   *    6   *  ** * *      *#
# # # # #*# # #*# # # # # #*# #
#    * * *** **  5   *    **  #
# #*# # # # #4# #n#1# # # # #*#
#          *     **      *  **#
# # #*# # # # # #*#*# #*# # # #
#   *   3    *   * *x* *   4  #
# # # # #*# # # # # # #*# #*# #
#   * **      *  *2           #
# # # # # # # # # #*# # # # #*#
#  ** *1  *    2              #
###############################