10 13 31
###############################
#p   *        *  ** * *      *#
# # # # #*# # #*# # # # # #*# #
#    * * *** **  *   *    **  #
# #f# # # # #4# #b#5# # # # # #
#          *     **      *  **#
# # #*# # # # # #*#*# #*# # # #
#   *        *   * *x* *   6  #
# # # # #*# # # # # # #*# #*# #
#   * **         *7        6  #
# # # # # # # # # #*# # # # #*#
#  *  *   *    7            8 #
###############################