7 13 31
###############################
#p * *    7   *  ** *        *#
# # # # #*# # #*# # # # # #*# #
#    * * *** **  5   *    **  #
# #*# # # # #4#   *#1# # # # #*#
#          *     **      *  **#
# # #*# # # # # #*# #*#*# # # #
#   *        *   * *x* *   4  #
# # # # #*# # # # # # #*# #*# #
#   *f**         *2      4    #
# # # # # # # # # #*# # # # #*#
#  i* *   *    3              #
###############################