8 13 31
###############################
#p * *        *  ** * *   4  *#
# # # # #*# # #*# # # # # #*# #
#    * * * * **  5   *    **  #
# #*# # # # #4# #b#1# # # # #*#
#          *     **      *  * #
# # #*# # # # # #*#*#*#*# # # #
#   *        *   * *x* *   4  #
# # # # #*# # # # # # #*# #*# #
#   ** *   6     *2    3      #
# # # # # # # # # #*# # # # #*#
#  ** *   *    2           7  #
###############################