105 13 31
###############################
#         S         S         #
# #   #   #   #   #   #   #   #
#   S                    S    #
# #   #   #   #   #   #   #   #
#                             #
# #   #   #   #p  #   #   #   #
#                             #
# #   #   #   #   #   #   #   #
#   S                    S    #
# #   #   #   #   #   #   #   #
#         S         S         #
###############################


S - Mob Spawner